   ________  ______  ____  _____ ______   __  ______    ____ 
  / ____/ / / / __ \/ __ \/ ___// ____/  /  |/  /   |  / __ \
 / /   / /_/ / / / / / / /\__ \/ __/    / /|_/ / /| | / /_/ /
/ /___/ __  / /_/ / /_/ /___/ / /___   / /  / / ___ |/ ____/ 
\____/_/ /_/\____/\____//____/_____/  /_/  /_/_/  |_/_/      
